onGetInstantAppResolveInfo(int[],String,InstantAppResolutionCallback) => onGetInstantAppResolveInfo(Intent, int[], String,  InstantAppResolutionCallback)
getUidUdpTxPackets(int) => getUidTxPackets(int)
hasText() => hasPrimaryClip()
buildDrawingCache(boolean) => setLayerType(int, Paint)
getThreadStatsTag() => TrafficStats#getThreadStatsTag()
getLayerType(View) => getLayerType()
enableRowScaling(boolean) => BrowseSupportFragment#enableRowScaling(boolean)
setUserVisibleHint(Fragment,boolean) => androidx.fragment.app.Fragment
setOverScrollMode(View,int) => setOverScrollMode(int)
isVolteEnabledByPlatform(Context) => isVolteEnabledByPlatform()
computeScrollOffset() => OverScroller#computeScrollOffset()
isNonTtyOrTtyOnVolteEnabled(Context) => isNonTtyOrTtyOnVolteEnabled()
getLocalizedOutputStream(OutputStream) => java.io.OutputStream
getParcelableData() => AccessibilityRecord#getParcelableData()
getMessage() => getVoicePrompt()
recycle() => AccessibilityRecord#recycle()
setIntent(Intent) => addAction(RemoteAction)
formatNanpNumber(Editable) => formatNumber(String phoneNumber, String defaultCountryIso)
getSupportedRefreshRates() => getSupportedModes()
setChildrenDrawingOrderEnabled(ViewGroup,boolean) => setChildrenDrawingOrderEnabled(boolean)
willNotCacheDrawing() => setLayerType(int, Paint)
onPasswordExpiring(Context,Intent) => onPasswordExpiring(Context, Intent, UserHandle)
setExpandedViewHolder(ViewHolder) => expandAction(GuidedAction, boolean)
getContainerId() => findContainer(int)
setDefaults(int) => enableVibration(boolean)
combineMeasuredStates(int,int) => combineMeasuredStates(int, int)
removeAction(int) => removeAction(AccessibilityAction)
getContextHubHandles() => getContextHubs()
endObject(long) => end()
setDefaultRequestProperty(String,String) => getDefaultRequestProperty(java.lang.String)
getMeasuredWidthAndState(View) => getMeasuredWidth()
onCreateActionView() => onCreateActionView(MenuItem)
createDragToOpenListener(Object,View) => createDragToOpenListener(ListPopupWindow, View)
shouldOfferSwitchingToNextInputMethod(IBinder) => shouldOfferSwitchingToNextInputMethod()
getAlpha(View) => getAlpha()
setSize(int,int) => setSize(int, int)
setAnalogForced(boolean) => setConfigFlag(int, boolean)
canScrollHorizontally(View,int) => canScrollHorizontally(int)
getActionMasked(MotionEvent) => getAction()
setExtraVisibility(int) => setInfoVisibility(int)
setLayerType(View,int,Paint) => setLayerType(int, Paint)
isVtEnabledByPlatform(Context) => isVtEnabledByPlatform()
notifyHorizontalEdgeReached(int,int,int) => notifyHorizontalEdgeReached(int, int, int)
saveConfiguration() => addNetwork(WifiConfiguration)
registerForCarrierPrivilegeRulesLoaded(Handler,int,Object) => registerForCarrierPrivilegeRulesLoaded(Handler, int, Object)
startRepeatedObject(long) => start()
isChildrenDrawnWithCacheEnabled() => setLayerType(int, Paint)
setBackgroundDrawable(Drawable) => setBackground(Drawable)
getUserDisplayName() => getUser()
setFadingEnabled(boolean) => setControlsOverlayAutoHideEnabled(boolean)
getCurrentMinute() => getMinute()
setItemCount(int) => AccessibilityRecord#setItemCount(int)
getUidUdpRxBytes(int) => getUidRxBytes(int)
setScrollable(boolean) => AccessibilityRecord#setScrollable(boolean)
isFinished() => OverScroller#isFinished()
getCurrentSync() => getCurrentSyncs()
getFinalY() => OverScroller#getFinalY()
iccCloseLogicalChannel(int,Message) => iccCloseLogicalChannel(int, Message)
getDisplayLabel(Context,int,int,CharSequence) => android.provider.ContactsContract
initWithRawContactsEntityUri(Uri) => init(Uri, String[], String, String[], String, Uri)
onSupportContentChanged() => onContentChanged()
setOperatorBrandOverride(String) => UiccProfile#setOperatorBrandOverride(String)
updateCallBarring(int,int,Message,String[]) => updateCallBarring(int, int, Message, String[], int)
openContactPhotoInputStream(ContentResolver,Uri) => android.provider.ContactsContract
queue(ByteBuffer,int) => queue(ByteBuffer)
getApplicationByType(int) => UiccProfile#getApplicationByType(int)
action(Context,int,boolean) => action(int, boolean, Pair[])
isTouchExplorationEnabled(AccessibilityManager) => isTouchExplorationEnabled()
getLatLong(float[]) => getLatLong()
dispatchChange(boolean) => dispatchChange(boolean, Uri)
onRequestChildFocus(RecyclerView,View,View) => onRequestChildFocus(RecyclerView, State, View, View)
setTint(int) => setAccentColor(int)
invalidate(Rect) => invalidate()
getSupportLoaderManager() => getInstance(LifecycleOwner) LoaderManager.getInstance(this)
startManagingCursor(Cursor) => android.content.CursorLoader
getMetadata() => getStatsMetadata()
destroyDrawingCache() => setLayerType(int, Paint)
formatNumber(Editable,int) => formatNumber(String phoneNumber, String defaultCountryIso)
setCurrentTime(int) => setCurrentPosition(long)
getInstalledAccessibilityServiceList(AccessibilityManager) => getInstalledAccessibilityServiceList()
getWidth() => getSize(Point)
setBroadcastSubscriber(long,long,PendingIntent) => setBroadcastSubscriber(PendingIntent, long, long)
setPriority(int) => setImportance(int)
setInput(KernelID,Allocation) => execute(Object...)
calledPartyBCDToString(byte[],int,int) => calledPartyBCDToString(byte[], int, int, int)
apply(Editor) => apply()
hideChild(ViewGroup,View) => hideChild(android.view.ViewGroup, android.view.View, int)
smoothSlideClosed() => closePane()
getOperatorBrandOverride() => UiccProfile#getOperatorBrandOverride()
from(Context) => getSystemService(Class)
getCarrierPhaseUncertainty() => getAccumulatedDeltaRangeUncertaintyMeters()
addGrid(GridBuilder) => addGridRow(GridRowBuilder)
setPresenceIcon(ImageView,int) => android.provider.ContactsContract
startScroll(int,int,int,int,int) => startScroll(int, int, int, int, int)
showProgressBar() => setProgressBarShown(boolean)
onPasswordFailed(Context,Intent) => onPasswordFailed(Context, Intent, UserHandle)
getControlsRowPresenter() => getPlaybackRowPresenter()
dispatchPictureInPictureModeChanged(boolean) => dispatchPictureInPictureModeChanged(boolean, Configuration)
isVolteProvisionedOnDevice(Context) => isVolteProvisionedOnDevice()
setEnabled(boolean) => isEnabled()
setCid(int) => NeighboringCellInfo(int, String, int)
onAbsorb(int) => EdgeEffect#onAbsorb(int)
hasCarrierPhase() => getAccumulatedDeltaRangeState()
<init>(CharSequence,CharSequence,int,boolean) => RecommendationInfo(String, String, List<InetAddress>, boolean)
hideStatusIcon(IBinder) => hideStatusIcon()
getPointerId(MotionEvent,int) => getPointerId(int)
visibility(Context,int,boolean) => visibility(int, boolean)
getChannel() => getSelector()
stopManagingCursor(Cursor) => android.content.CursorLoader
setAction(PendingIntent) => setInputAction(PendingIntent)
getVersion() => getLongVersion()
withExecutor(Executor) => setExecutor(Executor)
getPosition() => getLayoutPosition()
getCarrierPackageNamesForIntent(PackageManager,Intent) => getCarrierPackageNamesForIntent(PackageManager, Intent)
getAvailableBlocks() => getAvailableBlocksLong()
abandonAudioFocus(OnAudioFocusChangeListener) => abandonAudioFocusRequest(AudioFocusRequest)
canSlide() => isSlideable()
getY(MotionEvent,int) => getY()
setPhotoData(ContentResolver,Uri,byte[]) => android.provider.ContactsContract
addConfiguration(long,byte[]) => addConfig(long, byte[])
getFeatures(Locale) => getVoices()
unregisterRemoteController(RemoteController) => removeOnActiveSessionsChangedListener(android.media.session.MediaSessionManager.OnActiveSessionsChangedListener)
setActivated(View,boolean) => setActivated(boolean)
createSettingsIntent() => createSetupIntent()
fromHtml(String) => fromHtml(String, int)
getPivotY(View) => getPivotY()
getPivotX(View) => getPivotX()
setScrollY(int) => AccessibilityRecord#setScrollY(int)
setScrollX(int) => AccessibilityRecord#setScrollX(int)
getDrawableForDensity(int,int) => getDrawableForDensity(int, int, Theme)
requestSendAccessibilityEvent(ViewParent,View,AccessibilityEvent) => requestSendAccessibilityEvent(View, AccessibilityEvent)
formatJapaneseNumber(Editable) => formatNumber(String phoneNumber, String defaultCountryIso)
toHtml(Spanned) => toHtml(Spanned, int)
setPermissionCompatDelegate(PermissionCompatDelegate) => androidx.fragment.app.Fragment
defineClass(byte[],int,int) => defineClass(String, byte[], int, int)  defineClass(String, byte[], int, int)
getFormatTypeForLocale(Locale) => formatNumber(String phoneNumber, String defaultCountryIso)
onRequestPermissionsResult(int,String[],int[]) => androidx.fragment.app.Fragment
setProgressBackgroundColor(int) => setProgressBackgroundColorSchemeResource(int)
endRepeatedObject(long) => end()
untagSocket(Socket) => TrafficStats#untagSocket(Socket)
getUniversalPinState() => UiccProfile#getUniversalPinState()
getRecord(AccessibilityEvent,int) => getRecord(int)
onNestedPreScroll(CoordinatorLayout,V,View,int,int,int[]) => onNestedPreScroll(CoordinatorLayout, View, View, int, int, int[], int)
getItemOffsets(Rect,int,RecyclerView) => getItemOffsets(Rect, View, RecyclerView, State)
getUidTcpRxBytes(int) => getUidRxBytes(int)
write(ObjectOutput) => writeFields()
getFragmentManager() => getSupportFragmentManager()
shouldClearTask() => getPopUpTo()
getColorStateList(int) => getColorStateList(int, Theme)
inflateTitle(LayoutInflater,ViewGroup,Bundle) => onInflateTitleView(LayoutInflater,ViewGroup,Bundle)
getData(long) => getReports(long)
isTtyModeSupported() => isTtySupported()
queryGroups(ContentResolver,long) => android.provider.ContactsContract
iccExchangeSimIO(int,int,int,int,int,String,Message) => iccExchangeSimIO(int, int, int, int, int, String, Message)
updateConfiguration(Configuration,DisplayMetrics) => createConfigurationContext(Configuration)
getContentDescription() => AccessibilityRecord#getContentDescription()
showStatusIcon(IBinder,String,int) => showStatusIcon(int)
isAvailable() => android.net.ConnectivityManager.NetworkCallback
getItemClickListener() => getOnItemClickListener()
getMeasuredHeightAndState(View) => getMeasuredHeightAndState()
showChild(ViewGroup,View) => showChild(android.view.ViewGroup, android.view.View, int)
setTotalTimeLong(long) => setDuration(long)
setSupplementalIcon(Drawable,boolean,OnClickListener) => setSupplementalIcon(Drawable, boolean)
startUpdate(View) => startUpdate(ViewGroup)
isGraphic(char) => isGraphic(CharSequence)
getMaximumDrawingCacheSize() => getScaledMaximumDrawingCacheSize()
getButtonState(MotionEvent) => getButtonState()
getLocale() => getLocaleObject()
setVtSetting(Context,boolean) => setVtSetting(boolean)
hideProgressBar() => setProgressBarShown(boolean)
setOnUtteranceCompletedListener(OnUtteranceCompletedListener) => setOnUtteranceProgressListener(UtteranceProgressListener)
getEdgeSlop() => getScaledEdgeSlop()
setClearTask(boolean) => setPopUpTo(int, boolean)
startObject(long) => start()
getUidTcpTxSegments(int) => getUidTxPackets(int)
resizeBitmapSize(int) => resizeBitmapArea(int)
setOemUnlockEnabled(boolean) => setOemUnlockAllowedByUser(boolean)
playEarcon(String,int,HashMap<String, => playEarcon(String, int, Bundle, String)
isChecked() => AccessibilityRecord#isChecked()
injectInsrumentation(Instrumentation) => injectInstrumentation(android.app.Instrumentation)
registerMediaButtonEventReceiver(ComponentName) => setMediaButtonReceiver(PendingIntent)
runFinalizersOnExit(boolean) => exit(int)
getMeasuredState(View) => getMeasuredState()
getProvisionedValue(int) => getConfigInt(int)
requestAudioFocus(OnAudioFocusChangeListener,int,int) => requestAudioFocus(AudioFocusRequest)
getCapabilities() => getRttCapabilities()
setDrawingCacheBackgroundColor(int) => setLayerType(int, Paint)
getWindowId() => AccessibilityRecord#getWindowId()
fling(int,int,int,int,int,int,int,int,int,int) => fling(int, int, int, int, int, int, int, int, int, int)
setDividerInset(int) => setDividerInsets(int, int)
createPersonInMyContactsGroup(ContentResolver,ContentValues) => android.provider.ContactsContract
getUserId() => getUser()
getVersionCode() => getLongVersionCode()
setFullScreen(boolean) => AccessibilityRecord#setFullScreen(boolean)
getPreviewFrameRate() => getPreviewFpsRange(int[])
getFreeBlocks() => getFreeBlocksLong()
getDrawingCacheQuality() => setLayerType(int, Paint)
getNotification() => build()
addWord(Context,String,int,int) => addWord(Context, String, int, String, Locale)
setOnScrollListener(OnScrollListener) => addOnScrollListener(OnScrollListener)
sendMessage(int,int,ContextHubMessage) => sendMessageToNanoApp(  NanoAppMessage)
setShadowResource(int) => setShadowResourceLeft(int)
readLine() => java.io.BufferedReader#readLine()
getAxisValue(MotionEvent,int) => getAxisValue(int)
getAMPMString(int) => java.text.SimpleDateFormat
notifyVerticalEdgeReached(int,int,int) => notifyVerticalEdgeReached(int, int, int)
setVibrate(long[]) => setVibrationPattern(long[])
onGuidedActionEdited(GuidedAction) => onGuidedActionEditedAndProceed(GuidedAction)
loadContactPhoto(Context,Uri,int,Options) => android.provider.ContactsContract
closeFileDescriptor(FileDescriptor) => close(FileDescriptor)
isWfcProvisionedOnDevice(Context) => isWfcProvisionedOnDevice()
finish() => EdgeEffect#finish()
removeAccessibilityStateChangeListener(AccessibilityManager,AccessibilityStateChangeListener) => removeAccessibilityStateChangeListener(  AccessibilityManager.AccessibilityStateChangeListener)
clearWallpaper() => clear  WallpaperManager.clear()
onMultiWindowModeChanged(boolean) => onMultiWindowModeChanged(boolean, Configuration)
showSoftInputFromInputMethod(IBinder,int) => requestShowSelf(int)
hasCarrierCycles() => getAccumulatedDeltaRangeState()
setInstrumentaiton(Instrumentation) => setInstrumentation(android.app.Instrumentation)
saveLayerAlpha(float,float,float,float,int,int) => saveLayerAlpha(float, float, float, float, int)
synthesizeToFile(String,HashMap<String, => synthesizeToFile(CharSequence, Bundle, File, String)
hashCode() => AccessibilityRecord#hashCode()
getSliceKeywords(Slice) => getSliceKeywords()
findNanoAppOnHub(int,NanoAppFilter) => queryNanoApps(ContextHubInfo)
getCarrierPhase() => getAccumulatedDeltaRangeMeters()
clone() => RemoteViews(RemoteViews)
registerCallback(Callback) => createClient(ContextHubInfo, ContextHubClientCallback)
isOverScrolled() => OverScroller#isOverScrolled()
clearProfileOwner(ComponentName) => wipeData(int)
getActionIndex(MotionEvent) => getActionIndex()
registerListener(SensorListener,int) => registerListener(SensorEventListener, Sensor, int)
onAttach(Activity) => onAttach(Context)
getX(MotionEvent,int) => getX()
initialize(boolean,boolean) => createShadowOverlayContainer(Context)
getNanoAppInstanceInfo(int) => queryNanoApps(ContextHubInfo)
removeAccount(Account,AccountManagerCallback<Boolean>,Handler) => removeAccount(Account, Activity, AccountManagerCallback, Handler)
getToIndex() => AccessibilityRecord#getToIndex()
switchToLastInputMethod(IBinder) => switchToPreviousInputMethod()
onInitializeAccessibilityEvent(View,AccessibilityEvent) => onInitializeAccessibilityEvent(AccessibilityEvent)
isFadingEnabled() => isControlsOverlayAutoHideEnabled()
setTitleItem(IconCompat) => setTitleItem(Icon, int, boolean)
getVerticalMargin() => getVerticalSpacing()
setFitsSystemWindows(View,boolean) => setFitsSystemWindows(boolean)
pingSupplicant() => isWifiEnabled()
getClientState() => getEvents()
getFromIndex() => AccessibilityRecord#getFromIndex()
getBeforeText() => AccessibilityRecord#getBeforeText()
getUidTcpTxBytes(int) => getUidTxBytes(int)
addAction(int,CharSequence,PendingIntent) => addAction(Action)
invalidateChild(View,Rect) => onDescendantInvalidated(View, View)
setSource(View,int) => setSource(AccessibilityRecord, View, int)
incrementOperationCount(int,int) => incrementOperationCount(int, int)
getTargetPackage() => getCreatorPackage()
onAccessibilityStateChanged(boolean) => AccessibilityManager.AccessibilityStateChangeListener
allowPurging(boolean) => onTrimMemory(int)
setOrbColor(int,int) => setOrbColors(Colors)
fitSystemWindows(Rect) => dispatchApplyWindowInsets(WindowInsets)
copyToFileOrThrow(InputStream,File) => copy(InputStream, OutputStream)
getCurrentTime() => getCurrentPosition()
tagSocket(Socket) => TrafficStats#tagSocket(Socket)
sendStickyOrderedBroadcast(Intent,BroadcastReceiver,Handler,int,String,Bundle) => sendBroadcast(Intent)
hasPermanentMenuKey(ViewConfiguration) => hasPermanentMenuKey()
getAudioState() => getCallAudioState()
getTotalTime() => getDuration()
setX(View,float) => setX(float)
getFadingEdgeLength() => getScaledFadingEdgeLength()
vibrate(long[],int) => vibrate(VibrationEffect)
invalidateOptionsMenu(Activity) => invalidateOptionsMenu()
getSetting(ContentResolver,String,String) => android.provider.ContactsContract
setAudioStreamType(int) => android.media.AudioManager
getSubChannel() => getSelector()
setProvisionedStringValue(int,String) => setConfig(int, String)
isActionViewExpanded(MenuItem) => isActionViewExpanded()
openFileDescriptor(String,int) => open(String, int, int)
setButton(CharSequence,OnClickListener) => setButton(int, CharSequence, android.content.DialogInterface.OnClickListener)
isPassword() => AccessibilityRecord#isPassword()
setReparent(boolean) => android.transition.ChangeTransform
setSound(Uri) => setSound(Uri, AudioAttributes)
getUidTcpRxSegments(int) => getUidRxPackets(int)
getItemSelectedListener() => getOnItemSelectedListener()
startSync(Uri,Bundle) => requestSync(android.accounts.Account, String, android.os.Bundle)
getInfo() => unwrap()
encodePredefinedImProtocol(int) => android.provider.ContactsContract
removeGpsStatusListener(Listener) => unregisterGnssStatusCallback(GnssStatus.Callback)
toByteArray() => NdefMessage#toByteArray()
fillMarginLayoutParams(MarginLayoutParams,int,int) => fillMarginLayoutParams(View, ViewGroup.MarginLayoutParams, int, int)
getWfcMode(Context,boolean) => getWfcMode(boolean)
addEndItem(IconCompat,boolean) => addEndItem(Icon, int, boolean)
setMenuVisibility(Fragment,boolean) => androidx.fragment.app.Fragment
onMetadataChanged(RadioMetadata) => onProgramInfoChanged(RadioManager.ProgramInfo)
setAllowOptimization(boolean) => setReorderingAllowed(boolean)
getTouchSlop() => getScaledTouchSlop()
setPreviewFrameRate(int) => setPreviewFpsRange(int,int)
onDrawOver(Canvas,RecyclerView) => onDrawOver(Canvas, RecyclerView, RecyclerView.State)
jumpToCurrentState(Drawable) => jumpToCurrentState()
setWillNotCacheDrawing(boolean) => setLayerType(int, Paint)
setWfcMode(Context,int) => setWfcMode(int)
setSetting(ContentResolver,String,String,String) => android.provider.ContactsContract
abortReliableWrite(BluetoothDevice) => abortReliableWrite()
clearThreadStatsTag() => TrafficStats#clearThreadStatsTag()
appendSelectionArgs(String[],String[]) => appendSelectionArgs(String[], String[])
instantiateItem(View,int) => instantiateItem(android.view.ViewGroup, int)
getOemUnlockEnabled() => isOemUnlockAllowedByUser()
hasCarrierPrivilegeRules() => UiccProfile#hasCarrierPrivilegeRules()
isWfcEnabledByPlatform(Context) => isWfcEnabledByPlatform()
setCurrentHour(Integer) => setHour(int)
setCurrentItemIndex(int) => AccessibilityRecord#setCurrentItemIndex(int)
getMaximumFlingVelocity() => getScaledMaximumFlingVelocity()
cancelNotification(String,String,int) => cancelNotification(String key)
play(Context,Uri,boolean,int) => play(Context, Uri, boolean, AudioAttributes)
sendStickyBroadcast(Intent) => sendBroadcast(Intent)
onStart(Intent,int) => onStartCommand(Intent, int, int)
setUserRestriction(String,boolean) => addUserRestriction(  android.content.ComponentName, String)
getSliceActions(Slice) => getSliceActions()
isApplicationOnIcc(AppType) => UiccProfile#isApplicationOnIcc(AppType)
grantTrust(CharSequence,long,boolean) => grantTrust(CharSequence, long, int)
requestVisibleBehind(boolean) => onVisibleBehindCanceled()
onAudioStateChanged(Phone,AudioState) => onCallAudioStateChanged(Phone, CallAudioState)
requestFitSystemWindows() => requestApplyInsets()
setInputMethod(IBinder,String) => switchInputMethod(String)
getSensors() => getSensorList(int)
isBlocked(Context,String) => isBlocked(Context, String, Bundle)
setText(CharSequence) => setPrimaryClip(ClipData)
requestPermissions(Fragment,String[],int) => androidx.fragment.app.Fragment
removeQueueItemAt(int) => removeQueueItem(MediaDescriptionCompat)
getCurrentTimeLong() => getCurrentPosition()
setAddedCount(int) => AccessibilityRecord#setAddedCount(int)
setWindowLayoutMode(int,int) => setWidth(int)
setLabel(String) => addAction(RemoteAction)
getCurrVelocity() => OverScroller#getCurrVelocity()
getWallpaper() => getDrawable  WallpaperManager.get()
getScaledPagingTouchSlop(ViewConfiguration) => getScaledPagingTouchSlop()
springBack(int,int,int,int,int,int) => springBack(int, int, int, int, int, int)
getLabel() => getActions()
getPresenceIconResourceId(int) => android.provider.ContactsContract
getViewPosition() => getViewLayoutPosition()
getNativeFrameCount() => getBufferSizeInFrames()
formatIpAddress(int) => getHostAddress()
isEnabled() => AccessibilityRecord#isEnabled()
getCarrierPrivilegeStatusForCurrentTransaction(PackageManager) => UiccProfile#getCarrierPrivilegeStatusForCurrentTransaction(PackageManager)
getDayOfWeekString(int,int) => java.text.SimpleDateFormat
getSender() => getPerson()
setBufferedProgress(int) => setBufferedPosition(long)
collapseActionView(MenuItem) => collapseActionView()
setCurrentTimeLong(long) => setCurrentPosition(long)
setPassword(boolean) => AccessibilityRecord#setPassword(boolean)
setCurrentMinute(Integer) => setMinute(int)
getBufferedProgress() => getBufferedPosition()
updateImsServiceConfig(Context,int,boolean) => updateImsServiceConfig(boolean)
setScaleY(View,float) => setScaleY(float)
setScaleX(View,float) => setScaleX(float)
getColor(int) => getColor(int, Theme)
resolveSizeAndState(int,int,int) => resolveSizeAndState(int, int, int)
isEnhanced4gLteModeSettingEnabledByUser(Context) => isEnhanced4gLteModeSettingEnabledByUser()
setStreamMute(int,boolean) => adjustStreamVolume(int, int, int)
unloadNanoApp(int) => unloadNanoApp(ContextHubInfo, long)
switchToNextInputMethod(IBinder,boolean) => switchToNextInputMethod(boolean)
getCurrentItemIndex() => AccessibilityRecord#getCurrentItemIndex()
onPictureInPictureModeChanged(boolean) => onPictureInPictureModeChanged(boolean, Configuration)
setColor(int) => setAccentColor(int)
getYVelocity(VelocityTracker,int) => getYVelocity(int)
getIcon() => getActions()
setChildrenDrawingCacheEnabled(boolean) => setLayerType(int, Paint)
getActions() => getActionList()
getStorageState(File) => getExternalStorageState(File)
decodeImProtocol(String) => android.provider.ContactsContract
isDigital() => getLogicallyTunedTo()
release() => close()
startExpandedTransition(ViewHolder) => expandAction(GuidedAction, boolean)
addOption(Pattern,int) => addOption(Pattern, int, CharSequence)
stopLeScan(LeScanCallback) => stopScan(ScanCallback)
dump(String,FileDescriptor,PrintWriter,String[]) => enableDebugLogging(boolean)
isBluetoothA2dpOn() => getDevices(int)
getNetworkType() => setRequiredNetworkType(int)
setContentInfo(CharSequence) => setSubText(CharSequence)
isOpaque(View) => isOpaque()
saveLayer(float,float,float,float,Paint,int) => saveLayer(float, float, float, float, Paint)
isQuickScaleEnabled(Object) => isQuickScaleEnabled(ScaleGestureDetector)
getWallpaperDesiredMinimumWidth() =>  WallpaperManager.getDesiredMinimumWidth()
setVibrateSetting(int,int) => getRingerMode()
isHeading() => AccessibilityNodeInfoCompat#isHeading()
shouldVibrate(int) => getRingerMode()
toString(int) => size()
removeSessionCookie() => removeSessionCookies(ValueCallback)
addNmeaListener(NmeaListener) => addNmeaListener(OnNmeaMessageListener)
unregisterForCarrierPrivilegeRulesLoaded(Handler) => UiccProfile#unregisterForCarrierPrivilegeRulesLoaded(Handler)
areCarrierPriviligeRulesLoaded() => UiccProfile#areCarrierPriviligeRulesLoaded()
destroyItem(View,int,Object) => destroyItem(android.view.ViewGroup, int, Object)
setMotionEventSplittingEnabled(ViewGroup,boolean) => setMotionEventSplittingEnabled(boolean)
setDrawingCacheQuality(int) => setLayerType(int, Paint)
getAddedCount() => AccessibilityRecord#getAddedCount()
getBufferedProgressLong() => getBufferedPosition()
setOutput(KernelID,Allocation) => execute(Object...)
isAnalogForced() => isConfigFlagSet(int)
retainNonConfig() => retainNestedNonConfig()
sendEnvelopeWithStatus(String,Message) => sendEnvelopeWithStatus(String, Message)
setButton2(CharSequence,OnClickListener) => setButton(int, CharSequence, android.content.DialogInterface.OnClickListener)
setButton3(CharSequence,Message) => setButton(int, CharSequence, Message)
setBitmap(Bitmap) => setAvatar(Bitmap)
getPersistentDrawingCache() => setLayerType(int, Paint)
getNumApplications() => UiccProfile#getNumApplications()
addMessage(CharSequence,long,CharSequence) => addMessage(CharSequence, long, Person)
getInstance() => SharedPreferences.Editor
onAttachFragment(Fragment) => onAttachFragment(android.support.v4.app.Fragment)
getOverScrollMode(View) => getOverScrollMode()
getTotalTimeLong() => getDuration()
removeAllCookie() => removeAllCookies(ValueCallback)
getUidUdpRxPackets(int) => getUidRxPackets(int)
addAccessibilityStateChangeListener(AccessibilityManager,AccessibilityStateChangeListener) => addAccessibilityStateChangeListener(  AccessibilityManager.AccessibilityStateChangeListener)
setDataFetchOperation(long,PendingIntent) => setFetchReportsOperation(PendingIntent, long)
setOnClickListener(OnClickListener) => addAction(RemoteAction)
canScrollVertically(View,int) => canScrollVertically(int)
smoothSlideOpen() => openPane()
setupHeaderItemFocusHighlight(VerticalGridView) => setupHeaderItemFocusHighlight(ItemBridgeAdapter)
getFinalX() => OverScroller#getFinalX()
isPurgingAllowed() => onTrimMemory(int)
onCreateDialog(int) => onCreateDialog(int, Bundle)
isDrawingCacheEnabled() => setLayerType(int, Paint)
setTranslationX(View,float) => setTranslationX(float)
setTranslationY(View,float) => setTranslationY(float)
setSummarySubtitle(CharSequence,boolean) => setSummary(CharSequence, boolean)
getOnClickListener() => getActions()
dispatch(Callback) => dispatch(Callback, DispatcherState, Object)
onConsoleMessage(String,int,String) => onConsoleMessage(ConsoleMessage) onConsoleMessage(ConsoleMessage)
getRotation(View) => getRotation()
getCurrentHour() => getHour()
setTextAppearance(Context,int) => setTextAppearance(int)
speak(String,int,HashMap<String, => speak(CharSequence, int, Bundle, String)
getScrollBarSize() => getScaledScrollBarSize()
getCarrierPrivilegeStatus(PackageManager,String) => getCarrierPrivilegeStatus(PackageManager, String)
onInflate(Activity,AttributeSet,Bundle) => onInflate(Context, AttributeSet, Bundle)
getCheckItemIds() => getCheckedItemIds()
removeConfiguration(long) => removeConfig(long)
restoreAllState(Parcelable,List<Fragment>) => restoreAllState(Parcelable, FragmentManagerNonConfig)
checkMulticast(InetAddress,byte) => checkMulticast(java.net.InetAddress)
getDescription() => loadDescription(PackageManager)
setEnhanced4gLteModeSetting(Context,boolean) => setEnhanced4gLteModeSetting(boolean)
getFocusedVirtualView() => getAccessibilityFocusedVirtualViewId()
setRotationY(View,float) => setRotationY(float)
getCurrX() => OverScroller#getCurrX()
getCurrY() => OverScroller#getCurrY()
buildQuery(String[],String,String[],String,String,String,String) => buildQuery(String[], String, String, String, String, String)
onDraw(Canvas,RecyclerView) => onDraw(Canvas, RecyclerView, RecyclerView.State)
onStopNestedScroll(CoordinatorLayout,V,View) => onStopNestedScroll(CoordinatorLayout, View, View, int)
appendRecord(AccessibilityEvent,AccessibilityRecordCompat) => appendRecord(AccessibilityRecord)
inKeyguardRestrictedInputMode() => isKeyguardLocked()
copyToFile(InputStream,File) => copy(InputStream, OutputStream)
getDrawable(int) => getDrawable(int, Theme)
setPrimaryItem(View,int,Object) => setPrimaryItem(ViewGroup, int, Object)
isWfcEnabledByUser(Context) => isWfcEnabledByUser()
getMonthString(int,int) => java.text.SimpleDateFormat
getMinimumFlingVelocity() => getScaledMinimumFlingVelocity()
dispatchMultiWindowModeChanged(boolean) => dispatchMultiWindowModeChanged(boolean, Configuration)
setAutoMeasureEnabled(boolean) => isAutoMeasureEnabled()
setErrorMessage(CharSequence) => setErrorMessage(int, CharSequence)
getContextHubInfo(int) => getContextHubs()
updateCursor(View,int,int,int,int) => updateCursorAnchorInfo(View, CursorAnchorInfo)
onRequestSendAccessibilityEvent(ViewGroup,View,AccessibilityEvent) => onRequestSendAccessibilityEvent(View, AccessibilityEvent)
getTranslationX(View) => getTranslationX()
findPointerIndex(MotionEvent,int) => findPointerIndex(int)
isVtEnabledByUser(Context) => isVtEnabledByUser()
getTranslationY(View) => getTranslationY()
parse(InputStream,VCardInterpreter) => addInterpreter(VCardInterpreter)
getChildMeasureSpec(int,int,int,boolean) => getChildMeasureSpec(int, int, int, int, boolean)
setClassName(CharSequence) => AccessibilityRecord#setClassName(CharSequence)
getScaleY(View) => getScaleY()
getScaleX(View) => getScaleX()
addToMyContactsGroup(ContentResolver,long) => android.provider.ContactsContract
invalidateChildInParent(int[],Rect) => onDescendantInvalidated(View, View)
onSignalStrengthChanged(int) => onSignalStrengthsChanged(SignalStrength)
setWallpaper(InputStream) => setStream(InputStream)  WallpaperManager.set()
setEngineByPackageName(String) => TextToSpeech(Context, OnInitListener, String)
onPull(float,float) => onPull(float)
onMonitoringSystemChange(int,boolean,Location) => onMonitoringSystemChange(GeofenceHardwareMonitorEvent)
setStreamType(int) => setAudioAttributes(AudioAttributes)
getVibrateSetting(int) => getRingerMode()
onPasswordSucceeded(Context,Intent) => onPasswordSucceeded(Context, Intent, UserHandle)
numberToCalledPartyBCD(String) => numberToCalledPartyBCD(String, int)
addPreferredActivity(IntentFilter,int,ComponentName[],ComponentName) => startActivity(Intent) Context.startActivity()
getExtraVisibility() => getInfoVisibility()
isWatchingCursor(View) => requestCursorUpdates(int)
getWallpaperDesiredMinimumHeight() =>  WallpaperManager.getDesiredMinimumHeight()
loadNanoApp(int,NanoApp) => loadNanoApp(ContextHubInfo, NanoAppBinary)
getChildPosition(View) => getChildAdapterPosition(View)
clearDeviceOwnerApp(String) => wipeData(int)
getSeparator() => getSeparators()
tune(int,int) => tune(ProgramSelector)
copyFile(File,File) => copy(File, File)
setSaveFromParentEnabled(View,boolean) => setSaveFromParentEnabled(boolean)
setActionView(MenuItem,int) => setActionView(int)
getValidNotBefore() => getValidNotBeforeDate()
setFactory(LayoutInflater,LayoutInflaterFactory) => setFactory2(LayoutInflater, LayoutInflater.Factory2)
setOnActionExpandListener(MenuItem,OnActionExpandListener) => setOnActionExpandListener(MenuItem.OnActionExpandListener)
setChildrenDrawnWithCacheEnabled(boolean) => setLayerType(int, Paint)
getPointerCount(MotionEvent) => getPointerCount()
setBufferedProgressLong(long) => setBufferedPosition(long)
getUidUdpTxBytes(int) => getUidTxBytes(int)
onEditingModeChange(ViewHolder,GuidedAction,boolean) => onEditingModeChange(ViewHolder, boolean, boolean)
obtain(long,long,int,int,float,float,float,float,int,float,float,int,int) => obtain(long, long, int, float, float, float, float, int, float, float, int, int)
isVtProvisionedOnDevice(Context) => isVtProvisionedOnDevice()
setShowRunningNotification(boolean) => setNotificationVisibility(int)
getMaxScrollX() => getMaxScrollX(AccessibilityRecord)
getMaxScrollY() => getMaxScrollY(AccessibilityRecord)
setThreadStatsTag(int) => TrafficStats#setThreadStatsTag(int)
setRssi(int) => NeighboringCellInfo(int, String, int)
onNestedScroll(CoordinatorLayout,V,View,int,int,int,int) => onNestedScroll(CoordinatorLayout, View, View, int, int, int, int, int)
setPivotY(View,float) => setPivotX(float)
getSuggestions(TextInfo,int) => getSentenceSuggestions(TextInfo[], int)
isWiredHeadsetOn() => getDevices(int)
onStartNestedScroll(CoordinatorLayout,V,View,View,int) => onStartNestedScroll(CoordinatorLayout, View, View, View, int, int)
setRemoteAdapter(int,int,Intent) => setRemoteAdapter(int, Intent)
setShadowDrawable(Drawable) => setShadowDrawableLeft(Drawable d)
getValidNotAfter() => getValidNotAfterDate()
addPerson(String) => addPerson(Person)
abortAnimation() => OverScroller#abortAnimation()
setChecked(boolean) => AccessibilityRecord#setChecked(boolean)
setIcon(Drawable) => addAction(RemoteAction)
setShowAsAction(MenuItem,int) => setShowAsAction(int)
isScrollable() => AccessibilityRecord#isScrollable()
getApplicationIndex(int) => UiccProfile#getApplicationIndex(int)
fadeOut() => hideControlsOverlay(boolean)
getLoaderManager() => getInstance(LifecycleOwner) LoaderManager.getInstance(this)
addEarcon(String,String) => addEarcon(String, File)
setItemMargin(int) => setItemSpacing(int)
getLoadingState(Slice) => getLoadingState()
getXVelocity(VelocityTracker,int) => getXVelocity(int)
getCarrierCycles() => getAccumulatedDeltaRangeMeters()
getDescriprition() => getDescription()
addGpsStatusListener(Listener) => registerGnssStatusCallback(GnssStatus.Callback)
startActivityFromFragment(Fragment,Intent,int,Bundle) => startActivityFromFragment(  android.support.v4.app.Fragment,Intent,int,Bundle)
setTotalTime(int) => setDuration(long)
getApplication(int) => UiccProfile#getApplication(int)
registerRemoteController(RemoteController) => addOnActiveSessionsChangedListener(android.media.session.MediaSessionManager.OnActiveSessionsChangedListener, ComponentName)
getActionView(MenuItem) => getActionView()
getLanguage() => getVoice()
shouldShowRequestPermissionRationale(Fragment,String) => androidx.fragment.app.Fragment
onNestedScrollAccepted(CoordinatorLayout,V,View,View,int) => onNestedScrollAccepted(CoordinatorLayout, View, View, View, int, int)
addToGroup(ContentResolver,long,long) => android.provider.ContactsContract
setLocationModeForUser(ContentResolver,int,int) => setLocationEnabledForUser(boolean, int)
startDrag(ClipData,DragShadowBuilder,Object,int) => startDragAndDrop(ClipData, DragShadowBuilder, Object, int)  startDragAndDrop()
setContentDescription(CharSequence) => AccessibilityRecord#setContentDescription(CharSequence)
getKeyData(int,KeyData) => getDisplayLabel(int)
createSnapScroller(LayoutManager) => createScroller(RecyclerView.LayoutManager)
setHorizontalMargin(int) => setHorizontalSpacing(int)
setParcelableData(Parcelable) => AccessibilityRecord#setParcelableData(Parcelable)
getBlockSize() => getBlockSizeLong()
getStreamType() => setAudioAttributes(AudioAttributes)
peekWallpaper() => peekDrawable  WallpaperManager.peek()
getFactory(LayoutInflater) => setFactory2(LayoutInflater, LayoutInflater.Factory2)
isNull(int,int) => getType(int, int)
playSilence(long,int,HashMap<String, => playSilentUtterance(long, int, String)
addPostalLocation(Context,long,double,double) => android.provider.ContactsContract
resetAppWithAid(String) => UiccProfile#resetAppWithAid(String)
isWfcRoamingEnabledByUser(Context) => isWfcRoamingEnabledByUser()
calledPartyBCDFragmentToString(byte[],int,int) => calledPartyBCDFragmentToString(byte[], int, int, int)
createFromPdu(byte[]) => createFromPdu(byte[], String)
unregisterListener(SensorListener,int) => unregisterListener(SensorEventListener, Sensor)
setRotation(View,float) => setRotation(float)
getWindowTouchSlop() => getScaledWindowTouchSlop()
getEnabledAccessibilityServiceList(AccessibilityManager,int) => getEnabledAccessibilityServiceList(int)
setColorScheme(int) => setColorSchemeResources(int...)
getRecordCount(AccessibilityEvent) => getRecordCount()
onRelease() => EdgeEffect#onRelease()
setY(View,float) => setY(float)
iccTransmitApduLogicalChannel(int,int,int,int,int,int,String,Message) => iccTransmitApduLogicalChannel(int, int, int, int, int, int, String, Message)
isLocationProviderEnabled(ContentResolver,String) => isProviderEnabled(String)
hidden(Context,int) => hidden(int)
of(FragmentActivity) => getViewModelStore()
iconResourceId(int,Context) => icon(int)
jumpDrawablesToCurrentState(View) => jumpDrawablesToCurrentState()
getBitmap(String) => getBitmapId(String)
instantScrollToPosition(int) => jumpTo(int)
concatenateWhere(String,String) => concatenateWhere(String, String)
getBlockCount() => getBlockCountLong()
queryCallBarring(int,Message) => queryCallBarring(int, Message, int)
addRegistrationListener(int,ImsConnectionStateListener) => addRegistrationListener(ImsConnectionStateListener)
setFromIndex(int) => AccessibilityRecord#setFromIndex(int)
setMaxScrollX(int) => setMaxScrollX(AccessibilityRecord, int)
setMaxScrollY(int) => setMaxScrollY(AccessibilityRecord, int)
visible(Context,int) => visible(int)
getCanRetrieveWindowContent() => getCapabilities()
setToIndex(int) => AccessibilityRecord#setToIndex(int)
dupFileDescriptor(FileDescriptor) => dup(FileDescriptor)
setInputMethodAndSubtype(IBinder,String,InputMethodSubtype) => switchInputMethod(String, InputMethodSubtype)
onPopulateAccessibilityEvent(View,AccessibilityEvent) => onPopulateAccessibilityEvent(AccessibilityEvent)
expandActionView(MenuItem) => expandActionView()
getItemCount() => AccessibilityRecord#getItemCount()
getBytes(int,int,byte[],int) => getBytes()
setBeforeText(CharSequence) => AccessibilityRecord#setBeforeText(CharSequence)
restartPackage(String) => killBackgroundProcesses(String)
unregisterCallback(Callback) => close()
isTurnOffImsAllowedByPlatform(Context) => isTurnOffImsAllowedByPlatform()
setVerticalMargin(int) => setVerticalSpacing(int)
onPrepareDialog(int,Dialog) => onPrepareDialog(int, Dialog, Bundle)
setDrawingCacheEnabled(boolean) => setLayerType(int, Paint)
getSupportedPreviewFrameRates() => getSupportedPreviewFpsRange()
getClassName() => AccessibilityRecord#getClassName()
getState() => android.net.ConnectivityManager.NetworkCallback
setRemovedCount(int) => AccessibilityRecord#setRemovedCount(int)
setPersistentDrawingCache(int) => setLayerType(int, Paint)
dispatchReallyStop() => dispatchStop()
iccTransmitApduBasicChannel(int,int,int,int,int,String,Message) => iccTransmitApduBasicChannel(int, int, int, int, int, String, Message)
histogram(Context,String,int) => histogram(String, int)
getProvisionedStringValue(int) => getConfigString(int)
getRotationX(View) => getRotationX()
setProvisionedValue(int,int) => setConfig(int, int)
startLeScan(UUID[],LeScanCallback) => startScan(List, ScanSettings, ScanCallback)
getRotationY(View) => getRotationY()
removeOnRoutingChangedListener(OnRoutingChangedListener) => AudioRouting.OnRoutingChangedListener
count(Context,String,int) => count(String, int)
isFloat(int,int) => getType(int, int)
<init>(Context,int,Cursor,String[],int[]) => android.app.LoaderManager
cancelSync(Uri) => cancelSync(android.accounts.Account, String)
getRemovedCount() => AccessibilityRecord#getRemovedCount()
removeNmeaListener(NmeaListener) => removeNmeaListener(OnNmeaMessageListener)
getScrollY() => AccessibilityRecord#getScrollY()
getScrollX() => AccessibilityRecord#getScrollX()
getDefaultLanguage() => getDefaultVoice()
setQuickScaleEnabled(Object,boolean) => setQuickScaleEnabled(ScaleGestureDetector, boolean)
setOnPageChangeListener(OnPageChangeListener) => addOnPageChangeListener(OnPageChangeListener)
requestRestore(RestoreObserver) => onRestore(BackupDataInput, int, android.os.ParcelFileDescriptor) onRestore()
setRotationX(View,float) => setRotationX(float)
isFullScreen() => AccessibilityRecord#isFullScreen()
onGetInstantAppIntentFilter(int[],String,InstantAppResolutionCallback) => onGetInstantAppIntentFilter(Intent, int[], String,  InstantAppResolutionCallback)
encodeCustomImProtocol(String) => android.provider.ContactsContract
setLights(int,int,int) => enableLights(boolean)
hasCarrierPhaseUncertainty() => getAccumulatedDeltaRangeState()
getPrompt() => getVoicePrompt()
setControlsRowPresenter(PlaybackControlsRowPresenter) => setPlaybackRowPresenter(PlaybackRowPresenter)
getHeight() => getSize(Point)
onPasswordChanged(Context,Intent) => onPasswordChanged(Context, Intent, UserHandle)
setAlpha(View,float) => setAlpha(float)
getDrawingCache(boolean) => setLayerType(int, Paint)
getHorizontalMargin() => getHorizontalSpacing()
iccOpenLogicalChannel(String,int,Message) => iccOpenLogicalChannel(String, int, Message)
findViewHolderForPosition(int) => findViewHolderForLayoutPosition(int)
draw(Canvas) => android.widget.Space
getDrawingCacheBackgroundColor() => setLayerType(int, Paint)
parseMonolithicPackage(File,int) => parsePackage(File, int)
isConnectedOrConnecting() => android.net.ConnectivityManager.NetworkCallback
setPivotX(View,float) => setPivotX(float)
onMeasure(int,int) => android.widget.Space
authenticate(CryptoObject,CancellationSignal,int,AuthenticationCallback,Handler) => authenticate(CancellationSignal, Executor,  BiometricPrompt.AuthenticationCallback)
hideSoftInputFromInputMethod(IBinder,int) => requestHideSelf(int)
logrb(Level,String,String,String,String,Object[]) => logrb(java.util.logging.Level, java.lang.String,  java.lang.String, java.util.ResourceBundle, java.lang.String,  java.lang.Object...)
copyFileOrThrow(File,File) => copy(File, File)
getSource() => AccessibilityRecord#getSource()
sendStickyBroadcastAsUser(Intent,UserHandle) => sendBroadcast(Intent)
getConsiderGoneChildrenWhenMeasuring() => getMeasureAllChildren()
getHandle() => getNativeHandle()
